13,13,13,13,13,13,13,13,13,13,13,13,13,13,13,13,13,13,13,13,13,13,13,13,13
13,13,13,13,13,13,13,13,13,13,13,13,13,13,13,13,13,13,13,13,13,13,13,13,13
13,13,13,13,13,13,13,13,13,13,13,13,13,13,13,13,13,13,13,13,13,13,13,13,13
13,13,13,13,13,13,13,13,13,13,13,13,13,13,13,13,13,13,13,13,13,13,13,13,13
13,13,13,13,13,13,13,13,13,15,15,15,15,15,15,13,13,15,15,13,13,13,13,13,13
13,13,13,13,13,13,13,13,10,09,09,09,09,09,09,18,14,09,09,16,13,13,13,13,13
13,13,13,13,13,13,13,14,09,09,09,09,09,09,09,18,14,09,09,09,16,13,13,13,13
13,13,13,13,13,13,13,14,09,08,01,01,02,09,09,18,14,09,00,09,09,18,13,13,13
13,13,13,13,13,13,13,14,09,07,00,00,03,09,09,18,14,09,00,09,09,18,13,13,13
15,15,15,15,15,15,15,10,09,07,00,00,03,09,09,18,14,09,00,00,09,18,13,13,13
09,09,09,09,09,09,09,09,09,07,00,00,03,09,09,18,14,09,00,00,09,18,13,13,13
11,11,11,11,11,11,11,12,09,06,05,05,04,09,09,18,13,14,09,09,09,18,13,13,13
13,13,13,13,13,13,13,14,09,09,09,09,09,09,09,18,13,13,14,09,09,18,13,13,13
13,13,13,13,13,13,13,14,09,09,09,00,00,09,09,09,18,13,13,13,14,18,13,13,13
13,13,13,13,13,13,13,14,09,09,09,00,00,09,09,09,16,15,15,13,13,13,13,13,13
13,13,13,13,13,13,13,13,12,09,09,00,00,00,00,00,00,00,09,18,13,13,13,13,13
13,13,13,13,13,13,13,13,13,12,09,09,09,00,00,00,00,00,09,18,13,13,13,13,13
13,13,13,13,13,13,13,13,13,13,11,11,11,11,11,11,11,11,11,13,13,13,13,13,13
13,13,13,13,13,13,13,13,13,13,13,13,13,13,13,13,13,13,13,13,13,13,13,13,13
13,13,13,13,13,13,13,13,13,13,13,13,13,13,13,13,13,13,13,13,13,13,13,13,13

0,0,0,0,0,0,0,0,0,0,0,0,0,0,0,0,0,0,0,0,0,0,0,0,0
0,0,0,0,0,0,0,0,0,0,0,0,0,0,0,0,0,0,0,0,0,0,0,0,0
0,0,0,0,0,0,0,0,0,0,0,0,0,0,0,0,0,0,0,0,0,0,0,0,0
0,0,0,0,0,0,1,1,1,1,1,1,1,1,1,1,1,1,1,1,1,1,1,0,0
0,0,0,0,0,0,1,0,0,0,0,0,0,0,0,0,0,0,0,0,0,0,1,0,0
0,0,0,0,0,0,1,0,0,0,0,0,0,0,0,0,0,0,0,0,0,0,1,0,0
0,0,0,0,0,0,1,0,0,0,0,0,0,0,0,0,0,0,0,0,0,0,1,0,0
0,0,0,0,0,0,1,0,0,0,0,0,0,0,0,0,0,0,0,0,0,0,1,0,0
1,1,1,1,1,1,1,0,0,0,0,0,0,0,0,0,0,0,0,0,0,0,1,0,0
0,0,0,0,0,0,0,0,0,0,0,0,0,0,0,0,0,0,0,0,0,0,1,0,0
0,0,0,0,0,0,0,0,0,0,0,0,0,0,0,0,0,0,0,0,0,0,1,0,0
0,0,0,0,0,0,0,0,0,0,0,0,0,0,0,0,0,0,0,0,0,0,1,0,0
1,1,1,1,1,1,1,0,0,0,0,0,0,0,0,0,0,0,0,0,0,0,1,0,0
0,0,0,0,0,0,1,0,0,0,0,0,0,0,0,0,0,0,0,0,0,0,1,0,0
0,0,0,0,0,0,1,0,0,0,0,0,0,0,0,0,0,0,0,0,0,0,0,0,0
0,0,0,0,0,0,1,0,0,0,0,0,0,0,0,0,0,0,0,0,0,0,0,0,0
0,0,0,0,0,0,1,1,0,0,0,0,0,0,0,0,0,0,0,0,0,0,0,0,0
0,0,0,0,0,0,0,1,1,0,0,0,0,0,0,0,0,0,0,0,0,0,0,0,0
0,0,0,0,0,0,0,0,1,1,1,1,1,1,1,1,1,1,1,0,0,0,0,0,0
0,0,0,0,0,0,0,0,0,0,0,0,0,0,0,0,0,0,0,0,0,0,0,0,0